acheter| [sound:acheter.mp3]| to buy
advenir| [sound:advenir.mp3]| to happen
aider| [sound:aider.mp3]| to help, assist
aimer| [sound:aimer.mp3]| to like, to love
ajouter| [sound:ajouter.mp3]| to add
appeler| [sound:appeler.mp3]| to call, name, appeal
apporter| [sound:apporter.mp3]| to bring, bear
apprendre| [sound:apprendre.mp3]| to learn
arrêter| [sound:arr%C3%AAter.mp3]| to stop, arrest
attendre| [sound:attendre.mp3]| to wait, wait for, expect
connaître| [sound:conna%C3%AEtre.mp3]| to know, be acquainted
continuer| [sound:continuer.mp3]| to continue
contrôler| [sound:contr%C3%B4ler.mp3]| to check, inspect, test, supervise, control
corriger| [sound:corriger.mp3]| to correct
coucher| [sound:coucher.mp3]| to put to bed, lay, flatten
couper| [sound:couper.mp3]| to cut, switch off
courir| [sound:courir.mp3]| to run, race
coûter| [sound:co%C3%BBter.mp3]| to cost
croire| [sound:croire.mp3]| to believe
cuire| [sound:cuire.mp3]| to cook
décider| [sound:d%C3%A9cider.mp3]| to decide
décrire| [sound:d%C3%A9crire.mp3]| to describe
demander| [sound:demander.mp3]| to ask for
enlever| [sound:enlever.mp3]| to carry away, take away, remove
enseigner| [sound:enseigner.mp3]| to teach
entendre| [sound:entendre.mp3]| to hear, understand
envoyer| [sound:envoyer.mp3]| to send
espérer| [sound:esp%C3%A9rer.mp3]| to hope
essayer| [sound:essayer.mp3]| to try
étudier| [sound:%C3%A9tudier.mp3]| to study
inviter| [sound:inviter.mp3]| to invite
jouer| [sound:jouer.mp3]| to play, act (in a play), gamble
laver| [sound:laver.mp3]| to wash
lever| [sound:lever.mp3]| to lift, raise
lire| [sound:lire.mp3]| to read
manger| [sound:manger.mp3]| to eat
mettre| [sound:mettre.mp3]| to put (set), put on, place<br /><br />*many different meanings, and very common with expressions
nager| [sound:nager.mp3]| to swim
pleurer| [sound:pleurer.mp3]| to cry, weep, mourn
pleuvoir| [sound:pleuvoir.mp3]| to rain
porter| [sound:porter.mp3]| to wear, to carry
préférer| [sound:pr%C3%A9f%C3%A9rer.mp3]| to prefer
prendre| [sound:prendre.mp3]| to take (as in grab, bring, take notes,etc).<br /><br />*many uses, very common in expressions
se promener| [sound:se+promener.mp3]| to take a walk
promettre| [sound:promettre.mp3] | promise
proposer| [sound:proposer.mp3]| to propose, suggest
provenir| [sound:provenir.mp3]| to be from, be the result of, be due to
quitter| [sound:quitter.mp3]| to leave, quit, split up
raconter| [sound:raconter.mp3]| to tell, recount
recevoir| [sound:recevoir.mp3]| to receive, get
reconnaître| [sound:reconna%C3%AEtre.mp3]| to recognize, acknowledge
savoir| [sound:savoir.mp3]| to know (how)
sentir| [sound:sentir.mp3]| to feel, smell, perceive
souhaiter| [sound:souhaiter.mp3]| to wish
suivre| [sound:suivre.mp3]| to follow
susciter| [sound:susciter.mp3]| to arouse, give rise to
tenir| [sound:tenir.mp3]| to hold, grasp
terminer| [sound:terminer.mp3]| to terminate, finish, end
avoir besoin| [sound:avoir+besoin.mp3]| to need
blesser| [sound:blesser.mp3]| to hurt, injure, wound, offend
boire| [sound:boire.mp3]| to drink
brûler| [sound:br%C3%BBler.mp3]| to burn
cacher| [sound:cacher.mp3]| to hide
changer| [sound:changer.mp3]| to change
choisir| [sound:choisir.mp3]| to choose, select, pick
commencer| [sound:commencer.mp3]| to begin, start, commence
compléter| [sound:compl%C3%A9ter.mp3]| to make up, complete, complement, add to
comprendre| [sound:comprendre.mp3]| to understand, to include
dépêcher| [sound:d%C3%A9p%C3%AAcher.mp3]| to dispatch
détester| [sound:d%C3%A9tester.mp3]| to detest, dislike, hate
dire| [sound:dire.mp3]| to say, tell
donner | [sound:donner+.mp3]| to give
dormir| [sound:dormir.mp3]| to sleep
douter| [sound:douter.mp3]| to doubt
écouter| [sound:%C3%A9couter.mp3]| to listen
écrire| [sound:%C3%A9crire.mp3]| to write
effacer| [sound:effacer.mp3]| to erase, rub out, delete
élever| [sound:%C3%A9lever.mp3]| to raise, rear, bring up
fermer| [sound:fermer.mp3]| to close
finir| [sound:finir.mp3]| to finish, end, terminate, complete
forcer| [sound:forcer.mp3]| to force
fumer| [sound:fumer.mp3]| to smoke, steam
gagner| [sound:gagner.mp3]| to win, earn, gain
garder| [sound:garder.mp3]| to guard, keep, retain
goûter| [sound:go%C3%BBter.mp3]| to taste, have a snack, enjoy
haïr| [sound:ha%C3%AFr.mp3]| to hate
inclure| [sound:inclure.mp3]| to include, enclose
s'inquiéter| [sound:s%27inqui%C3%A9ter.mp3]| to worry, to be upset
neiger| [sound:neiger.mp3]| to snow
nettoyer| [sound:nettoyer.mp3]| to clean
noter| [sound:noter.mp3]| to write down| to notice| to mark, grade, assess
obéir| [sound:ob%C3%A9ir.mp3]| to obey
obtenir| [sound:obtenir.mp3]| to obtain, to get
occuper| [sound:occuper.mp3]| to occupy
offrir| [sound:offrir.mp3]| to offer
oublier| [sound:oublier.mp3]| to forget
ouvrir| [sound:ouvrir.mp3]| to open
pardonner| [sound:pardonner.mp3]| to pardon, forgive
parler| [sound:parler.mp3]| to talk
payer| [sound:payer.mp3]| to pay
penser| [sound:penser.mp3]| to think
perdre| [sound:perdre.mp3]| to lose (something, location, etc)
placer | [sound:placer+.mp3]| to place, put
refaire| [sound:refaire.mp3]| to redo
réfléchir| [sound:r%C3%A9fl%C3%A9chir.mp3]| to think, meditate, reflect, ponder
refuser| [sound:refuser.mp3]| to refuse, withhold
regarder| [sound:regarder.mp3]| to look at, watch
regretter| [sound:regretter.mp3]| to regret, miss
remercier| [sound:remercier.mp3]| to thank
remplacer| [sound:remplacer.mp3]| to replace
remplir| [sound:remplir.mp3]| to fill
répéter| [sound:r%C3%A9p%C3%A9ter.mp3]| to repeat. rehearse
répondre| [sound:r%C3%A9pondre.mp3]| to respond, reply, answer
réussir| [sound:r%C3%A9ussir.mp3]| to succeed, result
se réveiller| [sound:se+r%C3%A9veiller.mp3]| to wake up
révéler| [sound:r%C3%A9v%C3%A9ler.mp3]| to reveal, discover, bring to fame
aller| [sound:aller.mp3]| to go
arriver| [sound:arriver.mp3]| to arrive<br />to happen
entrer| [sound:entrer.mp3]| to enter, come in, go in
monter| [sound:monter.mp3]| to go up, climb, take up, bring up, mount
naître| [sound:na%C3%AEtre.mp3]| to be born
mourir| [sound:mourir.mp3]| to die
sortir| [sound:sortir.mp3]| to go out, leave
tomber| [sound:tomber.mp3]| to fall
descendre| [sound:descendre.mp3]| to descend go down, take down, bring down
devenir| [sound:devenir.mp3]| to become
partir| [sound:partir.mp3]| to leave, go away
parvenir| [sound:parvenir.mp3]| to reach, send, achieve
passer| [sound:passer.mp3]| to go, take, pass, spend time (numerous uses, common in expressions)
rentrer| [sound:rentrer.mp3]| to return (to a place)
rester| [sound:rester.mp3]| to remain, stay, be left (over)


revenir| [sound:revenir.mp3]| to come back
venir| [sound:venir.mp3]| to come
avoir| [sound:avoir.mp3]| to have
être| [sound:%C3%AAtre.mp3]| to be
faire| [sound:faire.mp3]| to make, do
pouvoir| [sound:pouvoir.mp3]| to be able, can
devoir| [sound:devoir.mp3]| to have to, must, ought, owe, should
vouloir| [sound:vouloir.mp3]| to want
abaisser| [sound:abaisser.mp3]| to lower, reduce, humilitate, humble
abasourdir| [sound:abasourdir.mp3]| to daze, deafen, stun, bewilder, stupefy
abattre| [sound:abattre.mp3]| to knock, pull, cut, shoot, or bring down, slaughter<br />to dishearten
abolir| [sound:abolir.mp3]| to abolish, do away with
absoudre| [sound:absoudre.mp3]| to absolve
s'abstenir| [sound:s%27abstenir.mp3]| to abstain
accepter| [sound:accepter.mp3]| to accept
acclamer| [sound:acclamer.mp3]| to acclaim, cheer, applaud
accompagner| [sound:accompagner.mp3]| to accompany
accorder| [sound:accorder.mp3]| to accord, grant, reconcile, admit
accourir| [sound:accourir.mp3]| to run to, run up to
accrocher| [sound:accrocher.mp3]| to hang (up)
accueillir| [sound:accueillir.mp3]| to welcome
accuser| [sound:accuser.mp3]| to accuse, acknowledge
achever| [sound:achever.mp3]| to achieve, complete, finish, end
acquérir| [sound:acqu%C3%A9rir.mp3]| to acquire
adjoindre| [sound:adjoindre.mp3]| to appoint (as on a team, position, etc.)
admettre| [sound:admettre.mp3]| to admit, pass, suppose
admirer| [sound:admirer.mp3]| to admire
adorer| [sound:adorer.mp3]| to adore, worship
adresser| [sound:adresser.mp3]| to address, send
affaiblir| [sound:affaiblir.mp3]| to weaken
agacer| [sound:agacer.mp3]| to annoy, irritate, pester, vex
agir| [sound:agir.mp3]| to act/behave, take effect
aménager| [sound:am%C3%A9nager.mp3]| to fit out, lay out, develop, plan, adjust
amener| [sound:amener.mp3]| to bring<br />to lead<br /> <br />*<b>amener</b> is generally used with people, <b>apporter</b> with things.
amuser| [sound:amuser.mp3]| to amuse, entertain
animer| [sound:animer.mp3]| to host, present, lead, bring to life, drive, sustain
annoncer| [sound:annoncer.mp3]| to announce
apercevoir| [sound:apercevoir.mp3]| to perceive
apparaître| [sound:appara%C3%AEtre.mp3]| to appear
appartenir| [sound:appartenir.mp3]| to belong, pertain
mémoriser| [sound:m%C3%A9moriser.mp3]| to memorize
approcher| [sound:approcher.mp3]| to approach, to come near, to bring near
approuver| [sound:approuver.mp3]| to approve (of)
armer| [sound:armer.mp3]| to arm
arracher| [sound:arracher.mp3]| to pull up/out, uproot
arraisonner| [sound:arraisonner.mp3]| to board
arranger| [sound:arranger.mp3]| to arrange
assaillir| [sound:assaillir.mp3]| to assail, attack, beset
s'asseoir| [sound:s%27asseoir.mp3]| to sit down
assister| [sound:assister.mp3]| to attend| to assist (at)| to be present (at)
assurer| [sound:assurer.mp3]| to assure, ensure, insure, guarantee
astreindre| [sound:astreindre.mp3]| to compel, oblige
attaquer| [sound:attaquer.mp3]| to attack, contest, tackle, launch, start work on
atteindre| [sound:atteindre.mp3]| to attain
attirer| [sound:attirer.mp3]| to attract, allure
attraper| [sound:attraper.mp3]| to catch
augmenter| [sound:augmenter.mp3]| to augment, increase
avancer| [sound:avancer.mp3]| to advance, go forward
avoir raison| [sound:avoir+raison.mp3]| to be right
baisser| [sound:baisser.mp3]| to lower, sink
balancer| [sound:balancer.mp3]| to sway, balance, swing<br />to weigh<br />to throw away
balayer| [sound:balayer.mp3]| to sweep
bâtir| [sound:b%C3%A2tir.mp3]| to build
battre| [sound:battre.mp3]| to beat
bavarder| [sound:bavarder.mp3]| to chat
bêler| [sound:b%C3%AAler.mp3]| to whine (like a sheep)
bénir| [sound:b%C3%A9nir.mp3]| to bless
blaguer| [sound:blaguer.mp3]| to joke
blâmer| [sound:bl%C3%A2mer.mp3]| to blame
blanchir| [sound:blanchir.mp3]| to whiten, launder, exonerate
bouger| [sound:bouger.mp3]| to budge, move
bouillir| [sound:bouillir.mp3]| to boil
briser| [sound:briser.mp3]| to break, ruin (career, life), put an end to
brosser| [sound:brosser.mp3]| to brush
broyer| [sound:broyer.mp3]| to grind
casser| [sound:casser.mp3]| to break, crack, quash
causer| [sound:causer.mp3]| to chat, cause
céder| [sound:c%C3%A9der.mp3]| to yield, cede, give up
ceindre| [sound:ceindre.mp3]| to put on
célébrer| [sound:c%C3%A9l%C3%A9brer.mp3]| to celebrate
cesser| [sound:cesser.mp3]| to cease
chanter| [sound:chanter.mp3]| to sing
charger| [sound:charger.mp3]| to burden, charge, load
chasser| [sound:chasser.mp3]| to hunt, chase, drive out
cheminer| [sound:cheminer.mp3]| to walk along, follow its course
chercher| [sound:chercher.mp3]| to look for
chérir| [sound:ch%C3%A9rir.mp3]| to cherish
chuchoter| [sound:chuchoter.mp3]| to whisper
circoncire| [sound:circoncire.mp3]| to circumcise
circonscrire| [sound:circonscrire.mp3]| to contain
circonvenir| [sound:circonvenir.mp3]| to circumvent| to get around
clore| [sound:clore.mp3]| to close, end 
coller| [sound:coller.mp3]| to stick, paste, put
combattre| [sound:combattre.mp3]| to combat, fight
commander| [sound:commander.mp3]| to command, order
commettre| [sound:commettre.mp3]| to commit
comparaître| [sound:compara%C3%AEtre.mp3]| to appear in court 
comparer| [sound:comparer.mp3]| to compare
élire| [sound:%C3%A9lire.mp3]| to elect, choose
s'éloigner| [sound:s%27%C3%A9loigner.mp3]| to move away, go away, withdraw, step back, keep back, keep away
embrasser| [sound:embrasser.mp3]| to kiss, embrace
emmener| [sound:emmener.mp3]| to lead, lead away, take away (persons)
empêcher| [sound:emp%C3%AAcher.mp3]| to hinder, prevent
employer| [sound:employer.mp3]| to employ, use
emprunter| [sound:emprunter.mp3]| to borrow (from)
encourager| [sound:encourager.mp3]| to encourage
endormir| [sound:endormir.mp3]| to fall asleep
enfreindre| [sound:enfreindre.mp3]| to infringe
s'enfuir| [sound:s%27enfuir.mp3]| to run away, slip away, escape, flee, fly away
engager| [sound:engager.mp3]| to commit, bind
enjoindre| [sound:enjoindre.mp3]| to enjoin, forbid, prohibit, command
ennuyer| [sound:ennuyer.mp3]| to bore, annoy, weary| | s'ennuyer = to be bored
énoncer| [sound:%C3%A9noncer.mp3]| to express, state
s'enquérir| [sound:s%27enqu%C3%A9rir.mp3]| to inquire
enregistrer| [sound:enregistrer.mp3]| to record, register, enter, show
enterrer| [sound:enterrer.mp3]| to bury
entraîner| [sound:entra%C3%AEner.mp3]| to train, bring about, lead
entreprendre| [sound:entreprendre.mp3]| to undertake, engage upon
entretenir| [sound:entretenir.mp3]| to look after
entrouvrir| [sound:entrouvrir.mp3]| to half-open
s'envoler| [sound:s%27envoler.mp3]| to take flight, take off
épeler| [sound:%C3%A9peler.mp3]| to spell
épouser| [sound:%C3%A9pouser.mp3]| to marry
éprouver| [sound:%C3%A9prouver.mp3]| to try, test, put to the test, feel, experience
équivaloir| [sound:%C3%A9quivaloir.mp3]| to be equivalent to
essuyer| [sound:essuyer.mp3]| to wipe, dust, wipe up
estimer| [sound:estimer.mp3]| to estimate
établir| [sound:%C3%A9tablir.mp3]| to establish, set up, draw up
éteindre| [sound:%C3%A9teindre.mp3]| to extinguish, shut down (computer), turn off
étonner| [sound:%C3%A9tonner.mp3]| to amaze, astonish, stun, surprise
étourdir| [sound:%C3%A9tourdir.mp3]| to stun, daze, make dizzy, deafen, bewilder
étreindre| [sound:%C3%A9treindre.mp3]| to embrace, grip
évaluer| [sound:%C3%A9valuer.mp3]| to evaluate, appraise, assess, estimate
éviter| [sound:%C3%A9viter.mp3]| to avoid
exagérer| [sound:exag%C3%A9rer.mp3]| to exaggerate
exclure| [sound:exclure.mp3]| to expel, suspend, exclude, dismiss
excuser| [sound:excuser.mp3]| to excuse
exiger| [sound:exiger.mp3]| to demand, require
exister| [sound:exister.mp3]| to exist
expliquer| [sound:expliquer.mp3]| to explain
explorer| [sound:explorer.mp3]| to explore
exprimer| [sound:exprimer.mp3]| to express
faiblir| [sound:faiblir.mp3]| to get weaker, fail, get fainter, die down, drop, diminish
faillir| [sound:faillir.mp3]| to fail| to almost (do something)
falloir| [sound:falloir.mp3]| to be necessary| | *MANY various uses, common with expressions
feindre| [sound:feindre.mp3]| to feign, make believe, pretend, simulate
féliciter| [sound:f%C3%A9liciter.mp3]| to congratulate
fendre| [sound:fendre.mp3]| to split, crack, cleave
feuilleter| [sound:feuilleter.mp3]| to leaf through
fixer | [sound:fixer+.mp3]| to fix, set
fonder| [sound:fonder.mp3]| to found, establish, lay the foundation, 
fondre| [sound:fondre.mp3]| to melt, dissolve, mix colors
fouiller| [sound:fouiller.mp3]| to dig deeply, excavate, search
fournir| [sound:fournir.mp3]| to furnish, supply
frapper| [sound:frapper.mp3]| to knock, hit, strike, rap 
frémir| [sound:fr%C3%A9mir.mp3]| to shudder, quiver, tremble
frire | [sound:frire+.mp3]| to deep-fry
gaspiller| [sound:gaspiller.mp3]| to waste
gâter| [sound:g%C3%A2ter.mp3]| to spoil, damage
geindre| [sound:geindre.mp3]| to moan 
geler| [sound:geler.mp3]| to freeze
gêner| [sound:g%C3%AAner.mp3]| to bother, hamper, constrict, embarass, hinder, impede, inconvenience
gérer| [sound:g%C3%A9rer.mp3]| to manage
grandir| [sound:grandir.mp3]| to grow (up, taller), increase
gratter| [sound:gratter.mp3]| to grate, scrape, scratch
grêler| [sound:gr%C3%AAler.mp3]| to hail (ice from the sky)
grimper| [sound:grimper.mp3]| to climb
gronder| [sound:gronder.mp3]| to chide, reprimand, scold
guérir| [sound:gu%C3%A9rir.mp3]| to cure, heal, remedy, recover
s'habiller| [sound:s%27habiller.mp3]| to get dressed, to dress (onself)
habiter| [sound:habiter.mp3]| to live (in), dwell (in), inhabit
hésiter| [sound:h%C3%A9siter.mp3]| to hesitate
hoqueter| [sound:hoqueter.mp3]| to hiccup, gasp
ignorer| [sound:ignorer.mp3]| to be unaware of, to be unaware of, to ignore
imposer| [sound:imposer.mp3]| to impose
indiquer| [sound:indiquer.mp3]| to incidate, point out, show
induire| [sound:induire.mp3]| to mislead
s'informer| [sound:s%27informer.mp3]| to find out, inquire, inform oneself
compter| [sound:compter.mp3]| to count, intend, expect to
concevoir| [sound:concevoir.mp3]| to conceive
conclure| [sound:conclure.mp3]| to conclude
concourir| [sound:concourir.mp3]| to compete (concurrently)
conduire| [sound:conduire.mp3]| to lead, drive, conduct, manage
conserver| [sound:conserver.mp3]| to preserve, conserve
confondre| [sound:confondre.mp3]| to confuse, confound
conjoindre| [sound:conjoindre.mp3]| to conjoin, unite
conquérir| [sound:conqu%C3%A9rir.mp3]| to conquer
conseiller| [sound:conseiller.mp3]| to advise, counsel, recommend
consentir| [sound:consentir.mp3]| to consent, agree
considérer| [sound:consid%C3%A9rer.mp3]| to consider
consommer| [sound:consommer.mp3]| to consume (drink, eat), consummate
construire| [sound:construire.mp3]| to construct, build
contenir| [sound:contenir.mp3]| to contain<br />to fit
conter| [sound:conter.mp3]| to relate, narrate, recount
contraindre| [sound:contraindre.mp3]| to constrain, restrain, compel
contredire| [sound:contredire.mp3]| to contradict
contrevenir| [sound:contrevenir.mp3]| to contravene
convaincre| [sound:convaincre.mp3]| to convince
convenir| [sound:convenir.mp3]| to suit, be appropriate| to agree, acknowledge
correspondre| [sound:correspondre.mp3]| to correspond (as in write, and to fit, relate)
corrompre| [sound:corrompre.mp3]| to corrupt
coudre| [sound:coudre.mp3]| to sew, stitch
couvrir| [sound:couvrir.mp3]| to cover
craindre| [sound:craindre.mp3]| to fear
créer| [sound:cr%C3%A9er.mp3]| to create
crier| [sound:crier.mp3]| to shout, cry out
cueillir| [sound:cueillir.mp3]| to gather, pick
culpabiliser| [sound:culpabiliser.mp3]| to make one feel guilty
danser| [sound:danser.mp3]| to dance
débattre| [sound:d%C3%A9battre.mp3]| to debate, discuss
décevoir| [sound:d%C3%A9cevoir.mp3]| to deceive, disappoint
déchirer| [sound:d%C3%A9chirer.mp3]| to rip
décorer| [sound:d%C3%A9corer.mp3]| to decorate
découdre| [sound:d%C3%A9coudre.mp3]| to take the stitches out of| to take off/out, to come off
décourager| [sound:d%C3%A9courager.mp3]| to discourage
découvrir| [sound:d%C3%A9couvrir.mp3]| to discover, uncover
se dédire| [sound:se+d%C3%A9dire.mp3]| to retract
déduire| [sound:d%C3%A9duire.mp3]| to deduce, infer, deduct
défaillir| [sound:d%C3%A9faillir.mp3]| to faint, falter
défaire| [sound:d%C3%A9faire.mp3]| to undo, untie
défendre| [sound:d%C3%A9fendre.mp3]| to defend, forbid, prohibit
défricher| [sound:d%C3%A9fricher.mp3]| to clear, open up, prepare the ground
dégager| [sound:d%C3%A9gager.mp3]| to free, clear (out), remove| to give off, emit
déjeuner| [sound:d%C3%A9jeuner.mp3]| to have lunch or breakfast
déménager| [sound:d%C3%A9m%C3%A9nager.mp3]| to move (furniture, etc.)
demeurer| [sound:demeurer.mp3]| to reside, live, remain, stay
démolir| [sound:d%C3%A9molir.mp3]| to demolish
dénoncer| [sound:d%C3%A9noncer.mp3]| to denounce, terminate
dépasser| [sound:d%C3%A9passer.mp3]| to pass, go beyond, exceed
dépeindre| [sound:d%C3%A9peindre.mp3]| to depict, describe, portray
dépendre| [sound:d%C3%A9pendre.mp3]| to depend (on)| to be dependent (on)| to take down (something that is hanging)
dépenser| [sound:d%C3%A9penser.mp3]| to spend (money)
déplaire| [sound:d%C3%A9plaire.mp3]| to displease
déranger| [sound:d%C3%A9ranger.mp3]| to disturb, derange
désirer| [sound:d%C3%A9sirer.mp3]| to desire<br />
désobéir| [sound:d%C3%A9sob%C3%A9ir.mp3]| to disobey
dessiner| [sound:dessiner.mp3]| to draw, sketch
déteindre| [sound:d%C3%A9teindre.mp3]| to take the color out of | to fade, rub off
détenir| [sound:d%C3%A9tenir.mp3]| to hold, detain| to be in power
détourner| [sound:d%C3%A9tourner.mp3]| to turn aside, turn away, divert
détruire| [sound:d%C3%A9truire.mp3]| to destroy
développer| [sound:d%C3%A9velopper.mp3]| to develop, spread out
dévêtir| [sound:d%C3%A9v%C3%AAtir.mp3]| to undress
deviner| [sound:deviner.mp3]| to guess
diminuer| [sound:diminuer.mp3]| to diminish, decrease, lesson
dîner| [sound:d%C3%AEner.mp3]| to dine (have dinner)
diriger| [sound:diriger.mp3]| to run, manage, lead, conduct, steer, pilot, direct, supervice
discourir| [sound:discourir.mp3]| to make a speech (discourse)
discuter| [sound:discuter.mp3]| to discuss, argue
disparaître| [sound:dispara%C3%AEtre.mp3]| to disappear
dissoudre| [sound:dissoudre.mp3]| to dissolve, disband
divorcer| [sound:divorcer.mp3]| to get divorced
doubler| [sound:doubler.mp3]| to double, repeat, dub
échapper| [sound:%C3%A9chapper.mp3]| to escape, avoid
échouer| [sound:%C3%A9chouer.mp3]| to fail, run aground
éclore| [sound:%C3%A9clore.mp3]| to open, hatch
éconduire| [sound:%C3%A9conduire.mp3]| to dismiss, reject, turn away
écraser| [sound:%C3%A9craser.mp3]| to crush, squash, stub out, mash, grind, pound, flatten
effrayer| [sound:effrayer.mp3]| to frighten
égayer| [sound:%C3%A9gayer.mp3]| to amuse, cheer up, enliven, entertain
retirer| [sound:retirer.mp3]| to draw (out) again, pull again, take something out/off
inscrire| [sound:inscrire.mp3]| to note down, score
insister| [sound:insister.mp3]| to insist
instruire| [sound:instruire.mp3]| to instruct
interdire| [sound:interdire.mp3]| to forbid, prohibit
s'intéresser| [sound:s%27int%C3%A9resser.mp3]| to be interested in
interroger| [sound:interroger.mp3]| to question, ask, interrogate
interrompre| [sound:interrompre.mp3]| to interrupt
intervenir| [sound:intervenir.mp3]| to intervene, play a part, give a talk
introduire| [sound:introduire.mp3]| to introduce, show in
inventer| [sound:inventer.mp3]| to invent, devise, make up
jaillir| [sound:jaillir.mp3]| to spurt out, gush out, flow, ring out, spring out, shoot out
jaser| [sound:jaser.mp3]| to chatter
jaunir| [sound:jaunir.mp3]| to turn yellow
jeter| [sound:jeter.mp3]| to throw, cast
joindre| [sound:joindre.mp3]| to join, contact
jouir| [sound:jouir.mp3]| to enjoy
juger| [sound:juger.mp3]| to judge, deem
jurer| [sound:jurer.mp3]| to swear, vow
kidnapper| [sound:kidnapper.mp3]| to kidnap
klaxonner| [sound:klaxonner.mp3]| to honk
lâcher| [sound:l%C3%A2cher.mp3]| to loosen, unleash, let go
laisser| [sound:laisser.mp3]| to let, allow, leave (alone)
lancer| [sound:lancer.mp3]| to hurl, launch, throw
loger| [sound:loger.mp3]| to live, lodge
louer| [sound:louer.mp3]| to praise, rent, rent out
luire| [sound:luire.mp3]| to shine, glisten, glimmer, twinkle
maigrir| [sound:maigrir.mp3]| to lose weight, grow thin
maintenir| [sound:maintenir.mp3]| to maintain, support
manquer| [sound:manquer.mp3]| to miss, lack
marcher| [sound:marcher.mp3]| to walk, march, run (machine), function
maudire| [sound:maudire.mp3]| to curse
méconnaître| [sound:m%C3%A9conna%C3%AEtre.mp3]| to misjudge, misunderstand, not to know, not to recognize
médire| [sound:m%C3%A9dire.mp3]| to malign, slander
mélanger| [sound:m%C3%A9langer.mp3]| to mix, blend, shuffle
menacer| [sound:menacer.mp3]| to threaten
mener| [sound:mener.mp3]| to lead, control
mentir| [sound:mentir.mp3]| to lie
mépriser| [sound:m%C3%A9priser.mp3]| to despise, scorn
mériter| [sound:m%C3%A9riter.mp3]| to deserve, to call for, merit
mesurer| [sound:mesurer.mp3]| to measure
modérer| [sound:mod%C3%A9rer.mp3]| to moderate, restrain, reduce
montrer| [sound:montrer.mp3]| to show, display, exhibit, point out
moquer| [sound:moquer.mp3]| to mock, make fun of
mordre| [sound:mordre.mp3]| to bite
moudre| [sound:moudre.mp3]| to mill, grind
mouiller| [sound:mouiller.mp3]| to get something wet, dampen, baste, drop anchor
naviguer| [sound:naviguer.mp3]| to navigate, sail, browse, surf (internet)
négliger| [sound:n%C3%A9gliger.mp3]| to neglect, be careless about, pay no attention to
négocier| [sound:n%C3%A9gocier.mp3]| to negotiate
neutraliser| [sound:neutraliser.mp3]| to neutralize, overpower
nier| [sound:nier.mp3]| to deny
noircir| [sound:noircir.mp3]| to blacken, dirty, darken
nommer| [sound:nommer.mp3]| to name, appoint
nouer| [sound:nouer.mp3]| to tie, knot
nourrir| [sound:nourrir.mp3]| to feed, nourish
se noyer| [sound:se+noyer.mp3]| to drown
nuire| [sound:nuire.mp3]| to harm, hinder
obliger| [sound:obliger.mp3]| to oblige
omettre| [sound:omettre.mp3]| to omit
oser| [sound:oser.mp3]| to dare
paraître| [sound:para%C3%AEtre.mp3]| to appear, seem
parcourir| [sound:parcourir.mp3]| to cover, travel up and down, go all over
partager| [sound:partager.mp3]| to divide up, share
participer| [sound:participer.mp3]| to participate, take part in, be involved in
patiner| [sound:patiner.mp3]| to skate
pécher| [sound:p%C3%A9cher.mp3]| to sin
pêcher| [sound:p%C3%AAcher.mp3]| to fish
se peigner| [sound:se+peigner.mp3]| to comb one's hair
peindre| [sound:peindre.mp3]| to paint, portray
peler| [sound:peler.mp3]| to peel
pendre| [sound:pendre.mp3]| to hang, suspend
pénétrer| [sound:p%C3%A9n%C3%A9trer.mp3]| to enter, penetrate
percevoir| [sound:percevoir.mp3]| to perceive, detect, feel
périr| [sound:p%C3%A9rir.mp3]| to perish, die
permettre| [sound:permettre.mp3]| to permit, allow, let
persuader| [sound:persuader.mp3]| to persuade, convince, induce
peser| [sound:peser.mp3]| to weigh
pianoter| [sound:pianoter.mp3]| to tap (like a piano), drum one's fingers
plaindre| [sound:plaindre.mp3]| to pity
plaire| [sound:plaire.mp3]| to please
plaisanter| [sound:plaisanter.mp3]| to joke (2)
planter| [sound:planter.mp3]| to plant, stick, dump
plier| [sound:plier.mp3]| to fold, bend
plonger| [sound:plonger.mp3]| to dive, swoop, plummet
pondre| [sound:pondre.mp3]| to lay (an egg)
poser| [sound:poser.mp3]| to lay, place, put, set, pose
posséder| [sound:poss%C3%A9der.mp3]| to possess, own, master
poursuivre| [sound:poursuivre.mp3]| to pursue, prosecute
pousser| [sound:pousser.mp3]| to push, grow
prédire| [sound:pr%C3%A9dire.mp3]| to predict, foretell
préparer| [sound:pr%C3%A9parer.mp3]| to prepare
prescrire| [sound:prescrire.mp3]| to prescribe, recommend
présenter| [sound:pr%C3%A9senter.mp3]| to present, introduce
pressentir| [sound:pressentir.mp3]| to sense, have a premonition
presser| [sound:presser.mp3]| to press, squeeze
prétendre| [sound:pr%C3%A9tendre.mp3]| to pretend, claim, maintain
prêter| [sound:pr%C3%AAter.mp3]| to lend
se prévaloir| [sound:se+pr%C3%A9valoir.mp3]| to pride onself on
prévenir| [sound:pr%C3%A9venir.mp3]| to warn, forestall, ward off, prevent
prévoir| [sound:pr%C3%A9voir.mp3]| to foresee
prier| [sound:prier.mp3]| to pray, supplicate, entreat beg, request
produire| [sound:produire.mp3]| to produce
projeter| [sound:projeter.mp3]| to project, plan, throw up, cast
prononcer| [sound:prononcer.mp3]| to pronounce, declare
proscrire| [sound:proscrire.mp3]| to prohibit, ban, proscribe, banish
protéger| [sound:prot%C3%A9ger.mp3]| to protect
prouver| [sound:prouver.mp3]| to prove
puer| [sound:puer.mp3]| to stink
punir| [sound:punir.mp3]| to punish
ralentir| [sound:ralentir.mp3]| to slow down
ranger| [sound:ranger.mp3]| to set (put) in order, tidy up
rappeler| [sound:rappeler.mp3]| to recall, remind, call again, call back
rassurer| [sound:rassurer.mp3]| to reassure
rater| [sound:rater.mp3]| to fail, miss<br />
ravir| [sound:ravir.mp3]| to delight, rob (somebody of something)
reconduire| [sound:reconduire.mp3]| to escort, renew
reconstruire| [sound:reconstruire.mp3]| to rebuild, reconstruct
recoudre| [sound:recoudre.mp3]| to sew back on, stitch up
recourir| [sound:recourir.mp3]| to race again, resort to, to turn to
recouvrir| [sound:recouvrir.mp3]| to cover, become covered
récrire| [sound:r%C3%A9crire.mp3]| to rewrite, write again
recueillir| [sound:recueillir.mp3]| to collect, gather, harvest
rédiger| [sound:r%C3%A9diger.mp3]| to write, compile, write up, draw up
redire| [sound:redire.mp3]| to repeat, say again
réduire| [sound:r%C3%A9duire.mp3]| to reduce, decrease, diminish
réélire| [sound:r%C3%A9%C3%A9lire.mp3]| to re-elect
rejeter| [sound:rejeter.mp3]| to reject, throw back, deny
rejoindre| [sound:rejoindre.mp3]| to rejoin, to agree with
relire| [sound:relire.mp3]| to reread
remarquer| [sound:remarquer.mp3]| to remark, notice, observe, distinguish
remettre| [sound:remettre.mp3]| to put (on) again, replace, put back, give back, postpone
rencontrer| [sound:rencontrer.mp3]| to meet, encounter
rendre| [sound:rendre.mp3]| to give back, return, render, vomit
renoncer| [sound:renoncer.mp3]| to renounce
renouveler| [sound:renouveler.mp3]| to renew, re-elect, repeat
renvoyer| [sound:renvoyer.mp3]| to dismiss, expel, suspend, send away
répandre| [sound:r%C3%A9pandre.mp3]| to spread, scatter, spill
reparaître| [sound:repara%C3%AEtre.mp3]| to reappear
réparer| [sound:r%C3%A9parer.mp3]| to repair
repasser| [sound:repasser.mp3]| to iron, pass again
repeindre| [sound:repeindre.mp3]| to repaint
se repentir| [sound:se+repentir.mp3]| to repent
repérer| [sound:rep%C3%A9rer.mp3]| to spot, locate
reprendre| [sound:reprendre.mp3]| to take back, recover, resume
réprimander| [sound:r%C3%A9primander.mp3]| to reprimand
reproduire| [sound:reproduire.mp3]| to reproduce
résoudre| [sound:r%C3%A9soudre.mp3]| to resolve, solve
ressembler| [sound:ressembler.mp3]| to resemble
ressentir| [sound:ressentir.mp3]| to feel
restreindre| [sound:restreindre.mp3]| to restrict
retenir| [sound:retenir.mp3]| to retain, keep, detain, hold back
revendiquer| [sound:revendiquer.mp3]| to demand, claim responsibility for, claim
rêver| [sound:r%C3%AAver.mp3]| to dream (during sleep)
revêtir| [sound:rev%C3%AAtir.mp3]| to put on (uniform)| to take on (appearance, character)
revoir| [sound:revoir.mp3]| to see again
riposter| [sound:riposter.mp3]| to retaliate, answer back, counter attack
rire| [sound:rire.mp3]| to laugh
rompre| [sound:rompre.mp3]| to break, burst, shatter, break off
rougir| [sound:rougir.mp3]| to redden, blush
rouler| [sound:rouler.mp3]| to roll, drive (a car), ride along
rouvrir| [sound:rouvrir.mp3]| to reopen
saisir| [sound:saisir.mp3]| to seize, grasp, comprehend
salir| [sound:salir.mp3]| to soil, dirty
satisfaire| [sound:satisfaire.mp3]| to satisfy
sauter| [sound:sauter.mp3]| to jump, leap
sauver| [sound:sauver.mp3]| to save, rescue
secouer| [sound:secouer.mp3]| to shake, shake off
secourir| [sound:secourir.mp3]| to help, relieve
séduire| [sound:s%C3%A9duire.mp3]| to charm, appeal to
séjourner| [sound:s%C3%A9journer.mp3]| to sojourn, live somewhere temporarily
sembler| [sound:sembler.mp3]| to seem
séparer| [sound:s%C3%A9parer.mp3]| to separate
serrer| [sound:serrer.mp3]| to grasp, press, squeeze, shake (hands)
servir| [sound:servir.mp3]| to serve, be useful
siffler| [sound:siffler.mp3]| to whistle, hiss, boo
signaler| [sound:signaler.mp3]| to signal, point out
signer| [sound:signer.mp3]| to sign
signifier| [sound:signifier.mp3]| to mean
skier| [sound:skier.mp3]| to ski
songer| [sound:songer.mp3]| to dream, think
sonner| [sound:sonner.mp3]| to ring
souffler| [sound:souffler.mp3]| to blow, pant
souffrir| [sound:souffrir.mp3]| to suffer, endure
souiller| [sound:souiller.mp3]| to soil, dirty, muddy, sully (reputation)
soumettre| [sound:soumettre.mp3]| to submit
sourire| [sound:sourire.mp3]| to smile
souscrire| [sound:souscrire.mp3]| to subscribe (book, new publication, fund)
soutenir| [sound:soutenir.mp3]| to support
se souvenir| [sound:se+souvenir.mp3]| to remember
subir| [sound:subir.mp3]| to suffer, undergo
subvenir| [sound:subvenir.mp3]| to provide for, support
sucer| [sound:sucer.mp3]| to suck
succomber| [sound:succomber.mp3]| to succumb, die
suffire| [sound:suffire.mp3]| to suffice, be enough
suggérer| [sound:sugg%C3%A9rer.mp3]| to suggest
supplier| [sound:supplier.mp3]| to beg, implore, supplicate
supposer| [sound:supposer.mp3]| to suppose
supporter| [sound:supporter.mp3]| to support, endure, hold up, prop up, tolerate
surprendre| [sound:surprendre.mp3]| to surprise
survenir| [sound:survenir.mp3]| to occur, arise, take place
survivre| [sound:survivre.mp3]| to survive
survoler| [sound:survoler.mp3]| to fly over
tapoter| [sound:tapoter.mp3]| to tap, pat
teindre| [sound:teindre.mp3]| to dye
téléphoner| [sound:t%C3%A9l%C3%A9phoner.mp3]| to call (on the telephone)
tendre| [sound:tendre.mp3]| to strain, stretch, tighten, tend
tenter| [sound:tenter.mp3]| to tempt, attempt, try
tirer| [sound:tirer.mp3]| to draw out, shoot, pull
tondre| [sound:tondre.mp3]| to shear, mow
tonner| [sound:tonner.mp3]| to thunder, boom
tordre| [sound:tordre.mp3]| to twist
toucher| [sound:toucher.mp3]| to touch, affect
tourner| [sound:tourner.mp3]| to turn
tousser| [sound:tousser.mp3]| to cough
tracer| [sound:tracer.mp3]| to draw (something out: water, card, etc.)| to draw (plan, line, circle)
traduire| [sound:traduire.mp3]| to translate
trahir| [sound:trahir.mp3]| to betray
traiter| [sound:traiter.mp3]| to treat (somebody a certain way), negotiate
transmettre| [sound:transmettre.mp3]| to transmit, transfer
transparaître| [sound:transpara%C3%AEtre.mp3]| to show through
traverser| [sound:traverser.mp3]| to traverse, cross
tressaillir| [sound:tressaillir.mp3]| to quiver, shudder, wince
tricher| [sound:tricher.mp3]| to trick, cheat
tuer| [sound:tuer.mp3]| to kill
tutoyer| [sound:tutoyer.mp3]| to use &quot;tu&quot; with somebody when speaking
unir| [sound:unir.mp3]| to unite, join
user| [sound:user.mp3]| to wear out, wear down
vaincre| [sound:vaincre.mp3]| to vanquish, conquer
valoir| [sound:valoir.mp3]| to be worth, be as good as, deserve, merit
vanter| [sound:vanter.mp3]| to vaunt, praise
varier| [sound:varier.mp3]| to vary
veiller| [sound:veiller.mp3]| to stay up (late), be watchful
venger| [sound:venger.mp3]| to avenge
verdir| [sound:verdir.mp3]| to turn green
vérifier| [sound:v%C3%A9rifier.mp3]| to verify, check, audit
verser| [sound:verser.mp3]| to pour
vêtir| [sound:v%C3%AAtir.mp3]| to clothe, dress
vieillir| [sound:vieillir.mp3]| to grow old, age
viser| [sound:viser.mp3]| to aim
vivre| [sound:vivre.mp3]| to live (be alive)
voiler| [sound:voiler.mp3]| to veil
voler| [sound:voler.mp3]| to fly, steal
voter| [sound:voter.mp3]| to vote
vouvoyer| [sound:vouvoyer.mp3]| to use &quot;vous&quot; when speaking with somebody
voyager| [sound:voyager.mp3]| to travel
zébrer| [sound:z%C3%A9brer.mp3]| to stripe
zézayer| [sound:z%C3%A9zayer.mp3]| to lisp
zoner| [sound:zoner.mp3]| to zone
frissonner| [sound:frissonner.mp3]| to quake (fear), shudder (horror), shiver (from cold)
rêvasser| [sound:r%C3%AAvasser.mp3]| to dream (when awake)
accroître| [sound:accro%C3%AEtre.mp3]| to increase, make greater, to enlarge
s'en aller| [sound:s%27en+aller.mp3]| to go away
s'amuser| [sound:s%27amuser.mp3]| to have a good time| to amuse oneself| to enjoy oneself
apprécier| [sound:appr%C3%A9cier.mp3]| to appreciate
s'arrêter| [sound:s%27arr%C3%AAter.mp3]| to stop oneself, to pause
assiéger| [sound:assi%C3%A9ger.mp3]| to besiege<br />to lay seige to
baver| [sound:baver.mp3]| to drool
brancher| [sound:brancher.mp3]| to plug in, connect
croître| [sound:cro%C3%AEtre.mp3]| to grow, increase
se débrouiller| [sound:se+d%C3%A9brouiller.mp3]| to manage, improvise, get by
décroître| [sound:d%C3%A9cro%C3%AEtre.mp3]| to decrease, diminish
se dépêcher| [sound:se+d%C3%A9p%C3%AAcher.mp3]| to hurry, hasten
émouvoir| [sound:%C3%A9mouvoir.mp3]| to move, touch, excite, arouse
enduire| [sound:enduire.mp3]| to coat (cover a surface)
s'étendre| [sound:s%27%C3%A9tendre.mp3]| to stretch oneself, to stretch out, lie down
s'évanouir| [sound:s%27%C3%A9vanouir.mp3]| to faint, lose consciousness, swoon, vanish
s'exclure mutuellement| [sound:s%27exclure+mutuellement.mp3]| to be mutually exclusive
s'excuser| [sound:s%27excuser.mp3]| to excuse oneself, apologize
se fâcher| [sound:se+f%C3%A2cher.mp3]| to become angry
se fier| [sound:se+fier.mp3]| to depend on, rely on, trust in
fuir| [sound:fuir.mp3]| to flee, fly off, shun<br />to leak (gas, oil, etc.)
se laver| [sound:se+laver.mp3]| to wash oneself
se lever| [sound:se+lever.mp3]| to get up
se méfier| [sound:se+m%C3%A9fier.mp3]| to beware, distrust, mistrust
se méprendre| [sound:se+m%C3%A9prendre.mp3]| to be mistaken, to mistake
se mettre| [sound:se+mettre.mp3]| to begin, start, place oneself
mirer| [sound:mirer.mp3]| to mirror
modeler| [sound:modeler.mp3]| to model, shape
mouvoir| [sound:mouvoir.mp3]| to move
s'occuper| [sound:s%27occuper.mp3]| to be busy, keep oneself busy
se plaindre| [sound:se+plaindre.mp3]| to complain, lament, moan
se presser| [sound:se+presser.mp3]| to be in a hurry, make haste, rush, crowd
programmer| [sound:programmer.mp3]| to program, plan
se rappeler| [sound:se+rappeler.mp3]| to remember, recall, recollect
se reposer| [sound:se+reposer.mp3]| to rest 
se retirer| [sound:se+retirer.mp3]| to retire, withdraw
se sauver| [sound:se+sauver.mp3]| to run away, to rush off, to escape
sécher| [sound:s%C3%A9cher.mp3]| to dry
se servir| [sound:se+servir.mp3]| to serve oneself, help oneself (to food and drink)
se taire| [sound:se+taire.mp3]| to be silent, quiet
traire| [sound:traire.mp3]| to milk
travailler| [sound:travailler.mp3]| to work
se tromper| [sound:se+tromper.mp3]| to be mistaken, to be wrong (about something)
tromper| [sound:tromper.mp3]| to cheat, deceive
trouver| [sound:trouver.mp3]| to find
se trouver| [sound:se+trouver.mp3]| to be located, be situated
vendre| [sound:vendre.mp3]| to sell
voir| [sound:voir.mp3]| to see
déverrouiller| [sound:d%C3%A9verrouiller.mp3]| to unlock, release, unboldt
détendre| | to relax
coopérer| | to cooperate
précéder| | to precede
régner| | to reign
rouspéter| | to grumble, grouch
tolérer| | to tolerate
ensorceler| | to bewitch
aboyer| | to bark
rayer| | to cross out
revendre| | to sell, sell off
grossir| | to gain weight
retourner| [sound:retourner.mp3]| to return
